木地板A|木の床A
铺石地面A|石畳A
地毯A|じゅうたんA
草席|ござ
洞A（木地板）|穴A（木の床）
石阶A|石段A
地面裂痕|床のひび割れ
桌子A|テーブルA
木地板B|木の床B
铺石地面B|石畳B
地毯B|じゅうたんB
地毯C|じゅうたんC
洞B（木地板）|穴B（木の床）
石阶B|石段B
地面污垢|床の汚れ
桌子B|テーブルB
铺石地面C|石畳C
铺石地面D|石畳D
地毯D|じゅうたんD
魔王城地面|魔王城の床
洞C（石头地面）|穴C（石の床）
石阶C|石段C
地面青苔|床の苔
桌子C|テーブルC
铺石地面E|石畳E
铺石地面F|石畳F
地毯E|じゅうたんE
地毯F|じゅうたんF
洞D|穴D
石阶D|石段D
铁丝网|金網
桌子D|テーブルD
